NO ./textures/greystone.xpm
SO ./textures/purplestone.xpm
WE ./textures/redbrick.xpm
EA ./textures/wood.xpm

F 100,255,100
C 163,208,230

        1111111111111111111111111
        1000000000110000000000001
        1011000001110000000000001
        1001000000000000000000001
111111111011000001110000000000001
100000000011000001110111110111111
11110111111111011100000011001
11110111111111011101010010001
11000000110101011100000010001
10000000000000001100000010001
10000000000000001101010011001
11000001110101011111011110N0111
11110111 1110101 101111010001
11111111 1111111 111111111111